0000100000
0000111000
0000001000
0000111000
0000100000
0000100000
0000100000
0000100000
0000100000
0000100000
