0000100000
0000111000
0000001000
0000111000
0000100000
0000100000
0011100000
0010100000
0010000000
0010000000
