0000100000
0000111000
0000001000
1111111000
1000100000
0000100000
0011100000
0000100000
0000100000
0000100000
