001100110000000110000000000000
001111110000011000001111000000
000000111100000110000000000000
001111110111100000000111100000
001100000000111100000000110000
001111110000000111100000000000
000000111111001111000000000111
000000000001111000000011100000
001110000000001100000000000000
000000000000000110000001111110
001100110000000110000001000010
001100110000000111111111000010
000000000000000000000000111110
000000001100110000011101100000
000000000000000000000000111110